------F--#######------------------------------
----------------------######------------------
################################----##########
---#---------------------------#--------------
----#----------#######---------#--------------
##---###-----------------------###########----
##-----------------------------#--------------
##---------#########-----------#--------------
##-----------------#############----##########
###----------------#############--------------
##-#---------------##########################-
##-----------------#----##-----#--------------
##-----#############----##-----############-##
##-----------------#----#####--#--------------
##-----------------#----##-----#--------------
############-------#----##-----#----##########
##-----------------#----##----------####---###
##-----------------#----##----------######-###
-------------------#----##--------------------
-------------------#----------------S---------
------#########-------------------------------