-#-----------###
-#--------F--##-
-#########---##-
---#######---##-
---#######---##-
-#-#######------
---############-
-S-----##-------
---###-###------
---#------------