----F--#
---###--
#------#
--####--
---#----
--S--#--